
"##########################"
"#      I                E#"
"#                        #"
"#                   M    #"
"#                        #"
"#                        #"
"#                        #"
"#                        #"
"#                        #"
"#P                       #"
"##########################"
