1111111111111111111
0010000000000010001
1010111011111010101
1010100010000010101
1010111011111110101
1010001000001000001
1011101011101010101
1000001010101010101
1111101010101010101
1000001010101010101
1011111010101010101
1000000010001011101
1011111010111010101
1010000010001010101
1010111111111010101
1010100000000010001
1010101111111111001
1010001000000000000
1111111111111111111